# #######
#   #   #
###     # 
#    #  #
## ######