#I#######
#   #   # 
###     # 
#    #  #
##O######