#####I#####
# #   #   #
# # # # # #
#   # # # #
# ### # # #
# #     # #
### ##### #
#   #   # #
# ### # # #
#   # #   #
#####O#####